|---x---||---x---||---x---||---x---||---x---|
|       ||       ||       ||       ||       |
x       xx       xx       xx       xx       x
|       ||       ||       ||       ||       |
|---x---||---x---||---x---||---x---||---x---|
|---x---||---x---||---x---||---x---||---x---|
|       ||       ||       ||       ||       |
x       xx       xx       xx       xx       x
|       ||       ||       ||       ||       |
|---x---||---x---||---x---||---x---||---x---|
|---x---||---x---||---x---||---x---||---x---|
|       ||       ||       ||       ||       |
x       xx       xx       xx       xx       x
|       ||       ||       ||       ||       |
|---x---||---x---||---x---||---x---||---x---|
|---x---||---x---||---x---||---x---||---x---|
|       ||       ||       ||       ||       |
x       xx       xx       xx       xx       x
|       ||       ||       ||       ||       |
|---x---||---x---||---x---||---x---||---x---|
|---x---||---x---||---x---||---x---||---x---|
|       ||       ||       ||       ||       |
x       xx       xx       xx       xx       x
|       ||       ||       ||       ||       |
|---x---||---x---||---x---||---x---||---x---|

I could create an x, y pixel grid, then decide to display it after knowing which pixel is what.